     AddddddddddddB 
AddBArLUUUUUUUUUURlB
kLRjkLbLURcccLRccaRj
klrlrjcjckccclrccckj
kLUUUbcldrRccccccArj
kjcccccccjkcccccckLb
kjcccccccjLRccAddrj 
kjcAdddBcllrcckLUUb 
kldrLURlddddddrj    
aUUUb aUUUUUUUUb    
,
     00000000333333 
33330000000003333333
33330003330003333333
33330003330003333333
00000003330003333333
00000000000003333333
0000000000330333333 
0000000000330333333 
0000000000000333    
00000 0000000333    
,
     11111111111111 
11111100000000000011
10011000000001100001
10011000000001100001
10000000011000000001
10000000011000000011
1000000001100000001 
1000000001100001111 
1000111000000001    
11111 1111111111    