     AddddddrlddddB 
AddBArLUUUUURLUUURlB
kLRjkLbLURcckLRccaRj
klrlrjcjckccklrccckj
kLUUUbcldrRckjcccArj
kjcccccccjkckjccckLb
kjcccccccjLRkjAddrj 
kjcAdddBcllrkjkLUUb 
kldrLURlddddrlrj    
aUUUb aUUUUURLUb    
,
     00000000333333 
33330000000003333333
33330003230003333343
33330002420003333343
00000003220003333343
00010000000003333333
0000000000330333333 
0010000100330333334 
0110000000000443    
00000 0000000333    
,
     11111111111111 
11111100000000000011
10011000000001100001
10011000000001100001
10000000011000000001
10000000011000000011
1000000001100000001 
1000000001100001111 
1000111000000001    
11111 1111111111    